#################
## #         B###
## ########  ####
## ##   A##  ####
##    #####  ####
##           ####
#################